#S#######################################
#     #     #   #   #   #     #   #     #
# # ### ##### ### # ### ### # # ####### #
# # # #       # # # # #     # #   # #   #
### # # ####### ### # # ####### ### ### #
#   #     # # #         # # # #       # #
### # ##### # ### # ##### # # # ### ### #
#   #       # #   # # #           #     #
# ##### ### # ##### # ### ### # ##### ###
# # #   #     #   # # #   #   #   #     #
# # ### ### ### ### # ### ########### # #
#         #     #       # # #     #   # #
### # # ### # ### ##### # # ### ##### ###
# # # #   # #   #   #       #     #   # #
# # ### ##### # # # ### # # # ### # # # #
# #   #     # #   # #   # #   #   # #   #
# # ############# ### # ### # ##### #####
#     #   # #   # # # #   # #   #   #   #
# ### # ### # ##### # ######### # # # ###
# #   #       #     #       #   # #     #
### ####### ### # ### ##### ####### ### #
#   #     #   # # #   #       # #   #   #
##### ### ### ### ##### ####### ### #####
#     #           #   # #   # #         #
# ########### ##### ####### # # # ##### #
#   #       #   #     # # # # # #   #   #
# ### # ### # # # ##### # # # # # # #####
# # # #   # # #     #   # #     # #     #
# # # # # ########### ### ### ####### ###
#     # #   #   #         #       #     #
####### # ##### # ####### ##### #########
#   #   #   # #     #           # #     #
### # ### ### ####### ### # ### # # # ###
#   # #     #   #       # #   # #   #   #
# # ####### # ######### # # # # # # #####
# #     # # #   # #     # # # #   # #   #
### ##### # # ### ##### ########### ### #
# #               #     #       # #   # #
# ### ### ##### # ### ### ### ### ### # #
#       # #     #           #     #     F
######################################### 
